				NO			     textures/simonkraft/respawn_anchor_side0.png																																																			







		F			 15  ,			6,		40  	 		 		 

EA 		textures/simonkraft/respawn_anchor_side2.png
C 35,19,73















				 	 	 	 













SO 				textures/simonkraft/respawn_anchor_side4.png
WE textures/simonkraft/respawn_anchor_side3.png


111111111111111
	111111000111111
111110111111111
1111000N0011111
1110010000010111
1100010S0010011
100001001110000001
11111   1 100001
1100011100011
11100001    0000111
111100000001111
111110000011111
11111100011111			11
111111111111111