				NO			     textures/simonkraft/respawn_anchor_side0.png																																																			







		F			 15  ,			6,		40  	 		 		 

EA 		textures/simonkraft/respawn_anchor_side2.png
C 35,19,73















				 	 	 	 













SO 				textures/simonkraft/respawn_anchor_side4.png
WE textures/simonkraft/respawn_anchor_side3.png


111111111111111
	111111000111111
111110000011111
1111000N0001111
111000000000111

110000000000011
100001111    100001
110D0011100D011
11100001    0000111
111100000001111
111110000011111
1111110001`11111
111111111111111
